Deck Layout (4 panes)
┌───────────┬───────────┬───────────┬───┐
│           │           │           │   │
│           │           │           │   │
│     1     │     2     │     3     │ 4 │
│           │           │           │   │
│           │           │           │   │
└───────────┴───────────┴───────────┴───┘
Full-height cards side by side
