Dwindle Layout (4 panes)
┌───────────────────┬───────────────────┐
│                   │                   │
│                   │         2         │
│         1         │                   │
│                   ├─────────┬─────────┤
│                   │         │         │
│                   │    3    │    4    │
└───────────────────┴─────────┴─────────┘
BSP cascade toward corner
