Grid Layout (4 panes)
┌───────────────────┬───────────────────┐
│                   │                   │
│         1         │         2         │
│                   │                   │
├───────────────────┼───────────────────┤
│                   │                   │
│         3         │         4         │
│                   │                   │
└───────────────────┴───────────────────┘
Even N x M grid distribution
