Main-Vertical (4 panes)
┌───────────────────┬───────────────────┐
│                   │         2         │
│                   ├───────────────────┤
│         1         │         3         │
│                   ├───────────────────┤
│                   │         4         │
│                   │                   │
└───────────────────┴───────────────────┘
Master left, stack right
