Main-Horizontal (4 panes)
┌───────────────────────────────────────┐
│                                       │
│                  1                    │
│                                       │
├───────────┬───────────┬───────────────┤
│     2     │     3     │       4       │
└───────────┴───────────┴───────────────┘
Master top, stack bottom
