Main-Center (4 panes)
┌───────┬───────────────────┬───────┐
│       │                   │   3   │
│       │                   ├───────┤
│   2   │         1         │   4   │
│       │                   │       │
│       │                   │       │
└───────┴───────────────────┴───────┘
Wide center pane
