Spiral Layout (4 panes)
┌───────────────────┬───────────────────┐
│                   │         2         │
│                   │                   │
│         1         ├─────────┬─────────┤
│                   │    4    │    3    │
│                   │         │         │
│                   ├─────────┴─────────┤
└───────────────────┴───────────────────┘
BSP with spiral trajectory
